Asteroids: 11
~-------------------------------------------------------------------------------------------------------------------------------------------------
-.............................................................@..................................................................................-
-................................................................................................................................................-
-................................................................................................................................................-
-..........................A.....................................................................................................................-
-................................................................................................................................................-
-.................................................................................................................2..............................-
-.........................................A......................................................................................................-
-..........................................................................A.....................................................................-
-...............A................................................................................................................................-
-.............................1.................................................................................................A................-
-.........................................................................................................A......................................-
-................................................................................................................................................-
-..........................................................................................A.....................................................-
-................................................................................................................................................-
-................................................................................................................................................-
-................................................................................................................................................-
-................................................................................................................................................-
-................................................................................................................................................-
-...........................................A....................................................................................................-
-................................................................................................................................................-
-...............................................................................A..................3......................A......................-
-................................................................................................................................................-
-................................................................................................................................................-
-................................................................................................................................................-
-................................................................................................................................................- 
-................................................................................................................................................-
-................................................................................................................................................-
-................................................................................................................................................-
-................................................................................................................................................-
-..............................................................................................A.................................................-
-................................................................................................................................................-
-................................................................................................................................................-
-..............................................................................................................................................S.-
--------------------------------------------------------------------------------------------------------------------------------------------------